11111111111111111111111111
1CCCCCCCCCCC11CCCCCCCCCCC1
1C1111C1111C11C1111C1111C1
1C1111C1111C11C1111C1111C1
1C1111C1111C11C1111C1111C1
1CCCCCCCCCCCCCCCCCCCCCCCC1
1C1111C1C11111111C1C1111C1
1CCCCCC1CCCC11CCCC1CCCCCC1
111111C111101101111C111111
111111C1XX00X000XX1C111111
111111C101110011101C111111
1ECCCCC001000000100CCCCCC1
111111C101111111101C111111
111111C1000000000X1C111111
111111X101111111101C111111
1XCCCCXCCCCC11CCCCCXCCCCC1
1C1111C1111C11C1111X1111C1
1CCC11CCCCCC0PCCCCCC11CCC1
111C11C1C11111111C1C11C111
1CCCCCC1CCCC11CCCC1CCCCCC1
1C111111111C11C111111111C1
1CCCCCCCCCCCCCCCCCCCCCCCC1
11111111111111111111111111