11111111111111111111111111111111
1P000000000000000000000010000CC1
1000111110001111100C1110000000X1
10001000000000000000001001000C01
10101101110011100000001000000101
10000000000000000001010000000011
10010X01111101110101111100000011
10000000000000100000100000100101
10001110100000C00000000001000001
10001000000000001000000000101011
10001000010011000000000000100001
100X000C0000100000000C0000110001
10010100000000010000000010100111
100111000000001000000010000010C1
100001000C0000000000000000001001
10000000000000000000001000100011
100000C000000011001100C000000111
10000000010000010100000000010001
100C0001000010100000010000010001
10000C00000001000000000011100001
10100100000100001000000001100001
100000C0100000000100000000001101
10000000000000010000000000011101
10000010000000001000000000000111
10000000000100100000001000010111
10000000000011100000010010000001
10C000000E00010000C0000000000001
100000000001100001000001100X0001
10010000000000010000000011000001
10000011110000000000010100000001
1000011X110000000000000011000001
11111111111111111111111111111111