1111111111
1001000001
10XXXCCCC1
1PCCCCE001
11CCC00111
1001100001
1XX11XXX11
100CCCXX11
1XX1100C11
1111111111