1111111111
1001000001
10000CCCC1
1PCCCCE001
11CCC00111
1001100001
1001100011
100CCC0011
1001100C11
1111111111