11111111111111111111
100100000000000000C1
10000111110111111001
1P0011E0000010100001
11111111111111000001
11111111111111000001
11111111111111111111