1111111111111111111111111111111111
1E0000000000000C000000000000000001
1010C10100100000001001000000010101
1010010010101010001001000C00010101
1P0000000000000000C000000000000001
1111111111111111111111111111111111
