11111111111111111111111111111111
1P0000000000XXX000X0X00010000CC1
1000111110001111100C1110000000X1
10001000000000000000001001000C01
10101101110011100000001000000101
10000XXX00XX00XXX001010000000011
10010X01111101110101111100000011
1000XXX0000X00100000100000100101
10001110100000C00XX0000001000001
10001000000000001000000000101011
10001000010011000000000000100001
100X000C0000100XXXX00C0000110001
10010100000000010000000010100111
100111000000001000000010000010C1
100001000C0000000000000000001001
10XXXXX0000000XXXXXXX01000100011
1XX000C000000011001100C000000111
10000000010000010100000000010001
100C0001000010100000010000010001
100X0C00000001000000000011100001
10100100000100001000000001100001
100000C0100000000100000000001101
10XX00000000000100000XX000011101
10000010000000001000XXX00X000111
100XX000000100100000001000010111
100000XX000011100000010010000001
10C000000E00010000C0000000000001
100000000001100001000001100X0001
10010000000000010000000011000001
100000111100000XX00001010000X001
1000011X1100000XX00X000011000001
11111111111111111111111111111111