111111
100101
100001
1P0011
110111
110111
100  101
100C01
110011
110h11h
110011
100101
100001
10E011
111111